max_time 1000
bomb_time 3
expl_duration 2
expl_range 4
+--------------+
|              |
|              |
|              |
|              |
|              |
|              |
|              |
|              |
|              |
|         E    |
+--------------+


